August 09	                 Poor Little Fool                          	Ricky Nelson
August 30	                              Little Star                          	The Elegants
October 04	                              It's All In The Game                          	Tommy Edwards
November 15	                              It's Only Make Believe                          	Conway Twitty
November 22	                              Tom Dooley                          	The Kingston Trio
November 29	                              It's Only Make Believe                          	Conway Twitty
December 06	                              To Know Him, Is To Love Him                          	The Teddy Bears
January 24	                              Smoke Gets In Your Eyes                          	The Platters
February 14	                              Stagger Lee                          	Lloyd Price
March 14	                              Venus                          	Frankie Avalon
April 18	                              Come Softly To Me                          	The Fleetwoods
May 16	                              The Happy Organ                          	Dave 'Baby' Cortez
May 23	                              Kansas City                          	Wilbert Harrison
June 06	                              The Battle Of New Orleans                          	Johnny Horton
July 18	                              Lonely Boy                          	Paul Anka
August 29	                              The Three Bells                          	The Browns
September 26	                              Sleep Walk                          	Santo & Johnny
October 10	                              Mack The Knife                          	Bobby Darin
November 21	                              Mr. Blue                          	The Fleetwoods
November 28	                              Mack The Knife                          	Bobby Darin
December 19	                              Heartaches By The Number                          	Guy Mitchell
January 02	                              Why                          	Frankie Avalon
January 09	                              El Paso                          	Marty Robbins
January 23	                              Running Bear                          	Johnny Preston
February 13	                              Teen Angel                          	Mark Dinning
February 27	                              The Theme From A Summer Place                          	Percy Faith And His Orchestra
May 28	                              Cathy's Clown                          	The Everly Brothers
July 02	                              Everybody's Somebody's Fool                          	Connie Francis
July 23	                              I'm Sorry                          	Brenda Lee
August 13	                              Itsy Bitsy Teenie Weenie Yellow Polkadot Bikini                          	Brian Hyland
September 24	                              The Twist                          	Chubby Checker
October 01	                              My Heart Has A Mind Of Its Own                          	Connie Francis
October 15	                              Mr. Custer                          	Larry Verne
October 22	                              Save The Last Dance For Me                          	The Drifters
October 29	                              I Want To Be Wanted                          	Brenda Lee
November 05	                              Save The Last Dance For Me                          	The Drifters
November 19	                              Georgia On My Mind                          	Ray Charles
November 26	                              Stay                          	Maurice Williams & The Zodiacs
January 14	                              Wonderland By Night                          	Bert Kaempfert And His Orchestra
February 04	                              Will You Love Me Tomorrow                          	The Shirelles
February 18	                              Calcutta                          	Lawrence Welk And His Orchestra
March 04	                              Pony Time                          	Chubby Checker
April 08	                              Blue Moon                          	The Marcels
April 29	                              Runaway                          	Del Shannon
May 27	                              Mother-In-Law                          	Ernie K-Doe
June 03	                              Travelin' Man                          	Ricky Nelson
June 10	                              Running Scared                          	Roy Orbison
June 17	                              Travelin' Man                          	Ricky Nelson
June 24	                              Moody River                          	Pat Boone
July 01	                              Quarter To Three                          	U.S. Bonds
July 15	                              Tossin' And Turnin'                          	Bobby Lewis
September 02	                              Wooden Heart                          	Joe Dowell
September 09	                              Michael                          	The Highwaymen
September 23	                              Take Good Care Of My Baby                          	Bobby Vee
October 14	                              Hit The Road Jack                          	Ray Charles and his Orchestra
October 28	                              Runaround Sue                          	Dion
November 11	                              Big Bad John                          	Jimmy Dean
December 16	                              Please Mr. Postman                          	The Marvelettes
December 23	                              The Lion Sleeps Tonight                          	The Tokens
January 06	                              The Lion Sleeps Tonight                          	The Tokens
January 13	                              The Twist                          	Chubby Checker
January 27	                              Peppermint Twist - Part I                          	Joey Dee & the Starliters
February 17	                              Duke Of Earl                          	Gene Chandler
March 10	                              Hey! Baby                          	Bruce Channel
March 31	                              Don't Break The Heart That Loves You                          	Connie Francis
April 07	                              Johnny Angel                          	Shelley Fabares
May 05	                              Soldier Boy                          	The Shirelles
June 02	                              I Can't Stop Loving You                          	Ray Charles
July 14	                              Roses Are Red (My Love)                          	Bobby Vinton
August 11	                              Breaking Up Is Hard To Do                          	Neil Sedaka
August 25	                              The Loco-Motion                          	Little Eva
September 01	                              Sheila                          	Tommy Roe
September 15	                              Sherry                          	The 4 Seasons
November 03	                              He's A Rebel                          	The Crystals
November 17	                              Big Girls Don't Cry                          	The 4 Seasons
December 22	                              Telstar                          	The Tornadoes
January 05	                              Telstar                          	The Tornadoes
January 12	                              Go Away Little Girl                          	Steve Lawrence
January 26	                              Walk Right In                          	The Rooftop Singers
February 09	                              Hey Paula                          	Paul and Paula
March 02	                              Walk Like A Man                          	The 4 Seasons
March 23	                              Our Day Will Come                          	Ruby And The Romantics
March 30	                              He's So Fine                          	The Chiffons
April 27	                              I Will Follow Him                          	Little Peggy March
May 18	                              If You Wanna Be Happy                          	Jimmy Soul
June 01	                              It's My Party                          	Lesley Gore
June 15	                              Sukiyaki                          	Kyu Sakamoto
July 06	                              Easier Said Than Done                          	The Essex
July 20	                              Surf City                          	Jan & Dean
August 03	                              So Much In Love                          	The Tymes
August 31	                              My Boyfriend's Back                          	The Angels
September 21	                             Blue Velvet                          	Bobby Vinton
October 12	                              Sugar Shack                          	Jimmy Gilmer And The Fireballs
November 16	                              Deep Purple                          	Nino Tempo & April Stevens
November 23	                              I'm Leaving It Up To You                          	Dale & Grace
December 07	                              Dominique                          	The Singing Nun (Soeur Sourire)
January 04	                              There! I've Said It Again                          	Bobby Vinton
February 01	                              I Want To Hold Your Hand                          	The Beatles
March 21	                              She Loves You                          	The Beatles
April 04	                              Can't Buy Me Love                          	The Beatles
May 16	                              My Guy                          	Mary Wells
May 30	                              Love Me Do                          	The Beatles
June 06	                              Chapel Of Love                          	The Dixie Cups
June 27	                              A World Without Love                          	Peter And Gordon
July 04	                              I Get Around                          	The Beach Boys
August 01	                              A Hard Day's Night                          	The Beatles
August 15	                              Everybody Loves Somebody                          	Dean Martin
August 22	                              Where Did Our Love Go                          	The Supremes
September 05	                              The House Of The Rising Sun                          	The Animals
October 17	                              Do Wah Diddy Diddy                          	Manfred Mann
October 31	                              Baby Love                          	The Supremes
November 28	                              Leader Of The Pack                          	The Shangri-Las
December 05	                              Ringo                          	Lorne Greene
December 12	                              Mr. Lonely                          	Bobby Vinton
December 19	                              Come See About Me                          	The Supremes
December 26	                              I Feel Fine                          	The Beatles
January 02	                              I Feel Fine                          	The Beatles
January 16	                              Come See About Me                          	The Supremes
January 23	                              Downtown                          	Petula Clark
February 06	                              You've Lost That Lovin' Feelin'                          	The Righteous Brothers
February 20	                              This Diamond Ring                          	Gary Lewis And The Playboys
March 06	                              My Girl                          	The Temptations
March 13	                              Eight Days A Week                          	The Beatles
March 27	                              Stop! In The Name Of Love                          	The Supremes
April 10	                              I'm Telling You Now                          	Freddie And The Dreamers
April 24	                              Game Of Love                          	Wayne Fontana & The Mindbenders
May 01	                              Mrs. Brown You've Got A Lovely Daughter                          	Herman's Hermits
May 22	                              Ticket To Ride                          	The Beatles
May 29	                              Help Me, Rhonda                          	The Beach Boys
June 12	                              Back In My Arms Again                          	The Supremes
June 19	                              I Can't Help Myself (Sugar Pie Honey Bunch)                          	Four Tops
June 26	                              Mr. Tambourine Man                          	The Byrds
July 03	                              I Can't Help Myself (Sugar Pie Honey Bunch)                          	Four Tops
July 10	                              (I Can't Get No) Satisfaction                          	The Rolling Stones
August 07	                              I'm Henry VIII, I Am                          	Herman's Hermits
August 14	                              I Got You Babe                          	Sonny & Cher
September 04	                              Help!                          	The Beatles
September 25	                              Eve Of Destruction                          	Barry McGuire
October 02	                              Hang On Sloopy                          	The McCoys
October 09	                              Yesterday                          	The Beatles
November 06	                              Get Off Of My Cloud                          	The Rolling Stones
November 20	                              I Hear A Symphony                          	The Supremes
December 04	                              Turn! Turn! Turn! (To Everything There Is A Season)                  	The Byrds
December 25	                              Over And Over                          	The Dave Clark Five
January 01	                              The Sound Of Silence                          	Simon & Garfunkel
January 08	                              We Can Work It Out                          	The Beatles
January 22	                              The Sound Of Silence                          	Simon & Garfunkel
January 29	                              We Can Work It Out                          	The Beatles
February 05	                              My Love                          	Petula Clark
February 19	                              Lightnin' Strikes                          	Lou Christie
February 26	                              These Boots Are Made For Walkin'                          	Nancy Sinatra
April 09	                              (You're My) Soul And Inspiration                          	The Righteous Brothers
April 30	                              Good Lovin'                          	The Young Rascals
May 07	                              Monday, Monday                          	The Mamas & The Papas
May 28	                              When A Man Loves A Woman                          	Percy Sledge
June 11	                              Paint It, Black                          	The Rolling Stones
June 25	                              Paperback Writer                          	The Beatles
July 02	                              Strangers In The Night                          	Frank Sinatra
July 09	                              Paperback Writer                          	The Beatles
July 16	                              Hanky Panky                          	Tommy James And The Shondells
July 30	                              Wild Thing                          	The Troggs
August 13	                              Summer In The City                          	The Lovin' Spoonful
September 03	                              Sunshine Superman                          	Donovan
September 10	                              You Can't Hurry Love                          	The Supremes
September 24	                              Cherish                          	The Association
October 15	                              Reach Out I'll Be There                          	Four Tops
November 05	                              Last Train To Clarksville                          	The Monkees
November 12	                              Poor Side Of Town                          	Johnny Rivers
November 19	                              You Keep Me Hangin' On                          	The Supremes
December 03	                              Winchester Cathedral                          	The New Vaudeville Band
December 10	                              Good Vibrations                          	The Beach Boys
December 17	                              Winchester Cathedral                          	The New Vaudeville Band
December 31	                              I'm A Believer                          	The Monkees
January 07	                              I'm A Believer                          	The Monkees
February 18	                              Kind Of A Drag                          	The Buckinghams
March 04	                              Ruby Tuesday                          	The Rolling Stones
March 11	                              Love Is Here And Now You're Gone                          	The Supremes
March 18	                              Penny Lane                          	The Beatles
March 25	                              Happy Together                          	The Turtles
May 13	                              The Happening                          	The Supremes
May 20	                              Groovin'                          	The Young Rascals
June 03	                              Respect                          	Aretha Franklin
June 17	                              Groovin'                          	The Young Rascals
July 01	                              Windy                          	The Association
July 29	                              Light My Fire                          	The Doors
August 19	                              All You Need Is Love                          	The Beatles
August 26	                              Ode To Billie Joe                          	Bobbie Gentry
September 23	                              The Letter                          	The Box Tops
October 21	                              To Sir With Love                          	Lulu
November 25	                              Incense And Peppermints                          	Strawberry Alarm Clock
December 02	                              Daydream Believer                          	The Monkees
December 30	                              Hello Goodbye                          	The Beatles
January 06	                              Hello Goodbye                          	The Beatles
February 03	                              Green Tambourine                          	The Lemon Pipers
February 10	                              Love Is Blue (L'amour Est Bleu)             	Paul Mauriat And His Orchestra
March 16	                              (Sittin' On) The Dock Of The Bay                          	Otis Redding
April 13	                              Honey                          	Bobby Goldsboro
May 18	                              Tighten Up                          	Archie Bell & The Drells
June 01	                              Mrs. Robinson                          	Simon & Garfunkel
June 22	                              This Guy's In Love With You                          	Herb Alpert
July 20	                              Grazing In The Grass                          	Hugh Masekela
August 03	                              Hello, I Love You                          	The Doors
August 17	                              People Got To Be Free                          	The Rascals
September 21	                              Harper Valley P.T.A.                          	Jeannie C. Riley
September 28	                              Hey Jude                          	The Beatles
November 30	                              Love Child                          	Diana Ross & The Supremes
December 14	                              I Heard It Through The Grapevine                          	Marvin Gaye
January 04	                              I Heard It Through The Grapevine                          	Marvin Gaye
February 01	                              Crimson And Clover                          	Tommy James And The Shondells
February 15	                              Everyday People                          	Sly & The Family Stone
March 15	                              Dizzy                          	Tommy Roe
April 12	                              Aquarius/Let The Sunshine In                          	The 5th Dimension
June 28	                              Love Theme From Romeo & Juliet                          	Henry Mancini And His Orchestra
July 12	                              In The Year 2525                          	Zager & Evans
August 23	                              Honky Tonk Women                          	The Rolling Stones
September 20	                              Sugar, Sugar                          	The Archies
October 18	                              I Can't Get Next To You                          	The Temptations
November 01	                              Suspicious Minds                          	Elvis Presley
November 08	                              Wedding Bell Blues                          	The 5th Dimension
November 29	                              Come Together/Something                          	The Beatles
December 06	                              Na Na Hey Hey Kiss Him Goodbye                          	Steam
December 20	                              Leaving On A Jet Plane                          	Peter, Paul & Mary
December 27	                              Someday We'll Be Together                          	Diana Ross & The Supremes
January 03	                              Raindrops Keep Fallin' On My Head                          	B.J. Thomas
January 31	                              I Want You Back                          	     Jackson 5
February 07	                              Venus                          	             The Shocking Blue
February 14	                              Thank You Falettinme Be Mice Elf Agin/Everybody Is A Star 	Sly & The Family Stone February 28	                              Bridge Over Troubled Water                          	Simon & Garfunkel
April 11	                              Let It Be                          	The Beatles
April 25	                              ABC                          	Jackson 5
May 09	                              American Woman/No Sugar Tonight                          	The Guess Who
May 30	                              Everything Is Beautiful                          	Ray Stevens
June 13	                              The Long And Winding Road/For You Blue                          	The Beatles
June 27	                              The Love You Save/I Found That Girl                          	Jackson 5
July 11	                              Mama Told Me (Not To Come)                          	Three Dog Night
July 25	                              (They Long To Be) Close To You                          	Carpenters
August 22	                              Make It With You                          	Bread
August 29	                              War                          	Edwin Starr
September 19	                              Ain't No Mountain High Enough                          	Diana Ross
October 10	                              Cracklin' Rosie                          	Neil Diamond
October 17	                              I'll Be There                          	Jackson 5
December 12	                              The Tears Of A Clown                          	Smokey Robinson & The Miracles
December 26	                              My Sweet Lord/Isn't It A Pity                          	George Harrison
January 02	                              My Sweet Lord/Isn't It A Pity                          	George Harrison
January 23	                              Knock Three Times                          	Dawn
February 13	                              One Bad Apple                          	The Osmonds
March 20	                              Me And Bobby McGee                          	Janis Joplin
April 03	                              Just My Imagination (Running Away With Me)                          	The Temptations
April 17	                              Joy To The World                          	Three Dog Night
May 29	                              Brown Sugar                          	The Rolling Stones
June 12	                              Want Ads                          	The Honey Cone
June 19	                              It's Too Late/I Feel The Earth Move                          	Carole King
July 24	                              Indian Reservation (The Lament Of The Cherokee Reservation Indian)               	The Raiders
July 31	                              You've Got A Friend                          	James Taylor
August 07	                              How Can You Mend A Broken Heart                          	Bee Gees
September 04	                              Uncle Albert/Admiral Halsey                          	Paul & Linda McCartney
September 11	                              Go Away Little Girl                          	Donny Osmond
October 02	                              Maggie May/Reason To Believe                          	Rod Stewart
November 06	                              Gypsys, Tramps & Thieves                          	Cher
November 20	                              Theme From Shaft                          	Isaac Hayes
December 04	                              Family Affair                          	Sly & The Family Stone
December 25	                              Brand New Key                          	Melanie
January 01	                              Brand New Key                          	Melanie
January 15	                              American Pie (Parts I & II)                          	Don McLean
February 12	                              Let's Stay Together                          	Al Green
March 18	                              Heart Of Gold                          	Neil Young
March 25	                              A Horse With No Name                          	America
April 15	                              The First Time Ever I Saw Your Face                          	Roberta Flack
May 27	                              Oh Girl                          	The Chi-lites
June 03	                              I'll Take You There                          	The Staple Singers
July 01	                              Song Sung Blue                          	Neil Diamond
July 08	                              Lean On Me                          	Bill Withers
July 29	                              Alone Again (Naturally)                          	Gilbert O'Sullivan
August 26	                              Brandy (You're A Fine Girl)                          	Looking Glass
September 02	                              Alone Again (Naturally)                          	Gilbert O'Sullivan
September 16	                              Black & White                          	Three Dog Night
September 23	                              Baby Don't Get Hooked On Me                          	Mac Davis
October 14	                              Ben                          	Michael Jackson
October 21	                              My Ding-A-Ling                          	Chuck Berry
November 04	                              I Can See Clearly Now                          	Johnny Nash
December 02	                              Papa Was A Rollin' Stone                          	The Temptations
December 09	                              I Am Woman                          	Helen Reddy
December 16	                              Me And Mrs. Jones                          	Billy Paul
January 06	                              You're So Vain                          	Carly Simon
January 27	                              Superstition                          	Stevie Wonder
February 03	                              Crocodile Rock                          	Elton John
February 24	                              Killing Me Softly With His Song                          	Roberta Flack
March 24	                              Love Train                          	The O'Jays
March 31	                              Killing Me Softly With His Song                          	Roberta Flack
April 07	                              The Night The Lights Went Out In Georgia                          	Vicki Lawrence
April 21	                              Tie A Yellow Ribbon Round The Ole Oak Tree              	Dawn Featuring Tony Orlando
May 19	                              You Are The Sunshine Of My Life                          	Stevie Wonder
May 26	                              Frankenstein                          	Edgar Winter Group
June 02	                              My Love                          	Paul McCartney & Wings
June 30	                              Give Me Love - (Give Me Peace On Earth)                          	George Harrison
July 07	                              Will It Go Round In Circles                          	Billy Preston
July 21	                              Bad, Bad Leroy Brown                          	Jim Croce
August 04	                              The Morning After                          	Maureen McGovern
August 18	                              Touch Me In The Morning                          	Diana Ross
August 25	                              Brother Louie                          	Stories
September 08	                              Let's Get It On                          	Marvin Gaye
September 15	                              Delta Dawn                          	Helen Reddy
September 22	                              Let's Get It On                          	Marvin Gaye
September 29	                              We're An American Band                          	Grand Funk
October 06	                              Half-Breed                          	Cher
October 20	                              Angie                          	The Rolling Stones
October 27	                              Midnight Train To Georgia                          	Gladys Knight And The Pips
November 10	                              Keep On Truckin' (Part 1)                          	Eddie Kendricks
November 24	                              Photograph                          	Ringo Starr
December 01	                              Top Of The World                          	Carpenters
December 15	                              The Most Beautiful Girl                          	Charlie Rich
December 29	                              Time In A Bottle                          	Jim Croce
January 05	                              Time In A Bottle                          	Jim Croce
January 12	                              The Joker                          	The Steve Miller Band
January 19	                              Show And Tell                          	Al Wilson
January 26	                              You're Sixteen                          	Ringo Starr
February 02	                              The Way We Were                          	Barbra Streisand
February 09	                              Love's Theme                          	Love Unlimited Orchestra
February 16	                              The Way We Were                          	Barbra Streisand
March 02	                              Seasons In The Sun                          	Terry Jacks
March 23	                              Dark Lady                          	Cher
March 30	                              Sunshine On My Shoulders                          	John Denver
April 06	                              Hooked On A Feeling                          	Blue Swede
April 13	                              Bennie And The Jets                          	Elton John
April 20	                              TSOP (The Sound Of Philadelphia)                 	MFSB featuring The Three Degrees
May 04	                              The Loco-Motion                          	Grand Funk
May 18	                              The Streak                          	Ray Stevens
June 08	                              Band On The Run                          	Paul McCartney & Wings
June 15	                              Billy, Don't Be A Hero                          	Bo Donaldson And The Heywoods
June 29	                              Sundown                          	Gordon Lightfoot
July 06	                              Rock The Boat                          	The Hues Corporation
July 13	                              Rock Your Baby                          	George McCrae
July 27	                              ANNIE'S SONG                          	John Denver
August 10	                              Feel Like Makin' Love                          	Roberta Flack
August 17	                              The Night Chicago Died                          	Paper Lace
September 14	                              I Shot The Sheriff                          	Eric Clapton
September 21	                              Can't Get Enough Of Your Love, Babe                          	Barry White
September 28	                              Rock Me Gently                          	Andy Kim
October 05	                              I Honestly Love You                          	Olivia Newton-John
October 19	                              Nothing From Nothing                          	Billy Preston
November 02	                              You Haven't Done Nothin                          	Stevie Wonder
November 09	                              You Ain't Seen Nothing Yet/Free Wheelin'                	Bachman-Turner Overdrive
November 23	                              I Can Help                          	Billy Swan
December 07	                              Kung Fu Fighting                          	Carl Douglas
December 21	                              Cat's In The Cradle                          	Harry Chapin
December 28	                              Angie Baby                          	Helen Reddy
January 04	                              Lucy In The Sky With Diamonds                          	Elton John
January 18	                              Mandy                          	Barry Manilow
January 25	                              Please Mr. Postman                          	Carpenters
February 01	                              Laughter In The Rain                          	Neil Sedaka
February 08	                              Fire                          	Ohio Players
February 15	                              You're No Good                          	Linda Ronstadt
February 22	                              Pick Up The Pieces                          	AWB
March 01	                              Best Of My Love                          	Eagles
March 08	                              Have You Never Been Mellow                          	Olivia Newton-John
March 15	                              Black Water                          	The Doobie Brothers
March 22	                              My Eyes Adored You                          	Frankie Valli
March 29	                              Lady Marmalade                          	Labelle
April 05	                              Lovin' You                          	Minnie Riperton
April 26	
                              (Hey Won't You Play) Another Somebody Done Somebody Wrong Song               	B.J. Thomas
May 03	
                              He Don't Love You (Like I Love You)                          	Tony Orlando & Dawn
May 24	
                              Shining Star                          	Earth, Wind & Fire
May 31	
                              Before The Next Teardrop Falls                          	Freddy Fender
June 07	
                              Thank God I'm A Country Boy                          	John Denver
June 14	
                              Sister Golden Hair                          	America
June 21	
                              Love Will Keep Us Together                          	Captain & Tennille
July 19	
                              Listen To What The Man Said                          	Wings
August 02	
                              One Of These Nights                          	Eagles
August 09	
                              Jive Talkin'                          	Bee Gees
August 23	
                              Fallin' In Love                          	Hamilton, Joe Frank & Reynolds
August 30	
                              Get Down Tonight                          	KC And The Sunshine Band
September 06	
                              Rhinestone Cowboy                          	Glen Campbell
September 20	
                              Fame                          	David Bowie
September 27	
                              I'm Sorry                          	John Denver
October 04	
                              Fame                          	David Bowie
October 11	
                              Bad Blood                          	Neil Sedaka
November 01	
                              Island Girl                          	Elton John
November 22	
                              That's The Way (I Like It)                          	KC And The Sunshine Band
November 29	
                              Fly, Robin, Fly                          	Silver Convention
December 20	
                              That's The Way (I Like It)                          	KC And The Sunshine Band
December 27	
                              Let's Do It Again                          	The Staple Singers
January 03	
                              Saturday Night                          	Bay City Rollers
January 10	
                              Convoy                          	C.W. McCall
January 17	
                              I Write The Songs                          	Barry Manilow
January 24	
                              Theme From Mahogany (Do You Know Where You're Going To)                          	Diana Ross
January 31	
                              Love Rollercoaster                          	Ohio Players
February 07	
                              50 Ways To Leave Your Lover                          	Paul Simon
February 28	
                              Theme From S.W.A.T.                          	Rhythm Heritage
March 06	
                              Love Machine (Part 1)                          	The Miracles
March 13	
                              December, 1963 (Oh, What a Night)                          	The 4 Seasons
April 03	
                              Disco Lady                          	Johnnie Taylor
May 01	
                              Let Your Love Flow                          	Bellamy Brothers
May 08	
                              Welcome Back                          	John Sebastian
May 15	
                              Boogie Fever                          	The Sylvers
May 22	
                              Silly Love Songs                          	Wings
May 29	
                              Love Hangover                          	Diana Ross
June 12	
                              Silly Love Songs                          	Wings
July 10	
                              Afternoon Delight                          	Starland Vocal Band
July 24	
                              Kiss And Say Goodbye                          	The Manhattans
September 04	
                              You Should Be Dancing                          	Bee Gees
September 11	
                              (Shake, Shake, Shake) Shake Your Booty                          	KC And The Sunshine Band
September 18	
                              Play That Funky Music                          	Wild Cherry
October 09	
                              A Fifth Of Beethoven                          	Walter Murphy & The Big Apple Band
October 16	
                              Disco Duck (Part I)                          	Rick Dees & His Cast Of Idiots
October 23	
                              If You Leave Me Now                          	Chicago
November 06	
                              Rock'n Me                          	Steve Miller
November 13	
                              Tonight's The Night (Gonna Be Alright)                          	Rod Stewart
January 01	
                              Tonight's The Night (Gonna Be Alright)                          	Rod Stewart
January 08	
                              You Don't Have To Be A Star (To Be In My Show)                          	Marilyn McCoo & Billy Davis, Jr.
January 15	
                              You Make Me Feel Like Dancing                          	Leo Sayer
January 22	
                              I Wish                          	Stevie Wonder
January 29	
                              Car Wash                          	Rose Royce
February 05	
                              Torn Between Two Lovers                          	Mary Macgregor
February 19	
                              Blinded By The Light                          	Manfred Mann's Earth Band
February 26	
                              New Kid In Town                          	Eagles
March 05	
                              Evergreen (Love Theme From A Star Is Born)                          	Barbra Streisand
March 26	
                              Rich Girl                          	Daryl Hall  John Oates
April 09	
                              Dancing Queen                          	ABBA
April 16	
                              Don't Give Up On Us                          	David Soul
April 23	
                              Don't Leave Me This Way                          	Thelma Houston
April 30	
                              Southern Nights                          	Glen Campbell
May 07	
                              Hotel California                          	Eagles
May 14	
                              When I Need You                          	Leo Sayer
May 21	
                              Sir Duke                          	Stevie Wonder
June 11	
                              I'm Your Boogie Man                          	KC And The Sunshine Band
June 18	
                              Dreams                          	Fleetwood Mac
June 25	
                              Got To Give It Up (Pt. I)                          	Marvin Gaye
July 02	
                              Gonna Fly Now                          	Bill Conti
July 09	
                              Undercover Angel                          	Alan O'Day
July 16	
                              Da Doo Ron Ron                          	Shaun Cassidy
July 23	
                              Looks Like We Made It                          	Barry Manilow
July 30	
                              I Just Want To Be Your Everything                          	Andy Gibb
August 20	
                              Best Of My Love                          	The Emotions
September 17	
                              I Just Want To Be Your Everything                          	Andy Gibb
September 24	
                              Best Of My Love                          	The Emotions
October 01	
                              Star Wars Theme/Cantina Band                          	Meco
October 15	
                              You Light Up My Life                          	Debby Boone
December 24	
                              How Deep Is Your Love                          	Bee Gees
January 07	
                              How Deep Is Your Love                          	Bee Gees
January 14	
                              Baby Come Back                          	Player
February 04	
                              Stayin' Alive                          	Bee Gees
March 04	
                              (Love Is) Thicker Than Water                          	Andy Gibb
March 18	
                              Night Fever                          	Bee Gees
May 13	
                              If I Can't Have You                          	Yvonne Elliman
May 20	
                              With A Little Luck                          	Wings
June 10	
                              You're The One That I Want                          	John Travolta & Olivia Newton-John
June 17	
                              Shadow Dancing                          	Andy Gibb
August 05	
                              Miss You                          	The Rolling Stones
August 12	
                              Three Times A Lady                          	Commodores
August 26	
                              Grease                          	Frankie Valli
September 09	
                              Boogie Oogie Oogie                          	A Taste Of Honey
September 30	
                              Kiss You All Over                          	Exile
October 28	
                              Hot Child In The City                          	Nick Gilder
November 04	
                              You Needed Me                          	Anne Murray
November 11	
                              MacArthur Park                          	Donna Summer
December 02	
                              You Don't Bring Me Flowers                          	Barbra Streisand & Neil Diamond
December 09	
                              Le Freak                          	Chic
December 16	
                              You Don't Bring Me Flowers                          	Barbra Streisand & Neil Diamond
December 23	
                              Le Freak                          	Chic
January 06	
                              Too Much Heaven                          	Bee Gees
January 20	
                              Le Freak                          	Chic
February 10	
                              Da Ya Think I'm Sexy?                          	Rod Stewart
March 10	
                              I Will Survive                          	Gloria Gaynor
March 24	
                              Tragedy                          	Bee Gees
April 07	
                              I Will Survive                          	Gloria Gaynor
April 14	
                              What A Fool Believes                          	The Doobie Brothers
April 21	
                              Knock On Wood                          	Amii Stewart
April 28	
                              Heart Of Glass                          	Blondie
May 05	
                              Reunited                          	Peaches & Herb
June 02	
                              Hot Stuff                          	Donna Summer
June 09	
                              Love You Inside Out                          	Bee Gees
June 16	
                              Hot Stuff                          	Donna Summer
June 30	
                              Ring My Bell                          	Anita Ward
July 14	
                              Bad Girls                          	Donna Summer
August 18	
                              Good Times                          	Chic
August 25	
                              My Sharona                          	The Knack
October 06	
                              Sad Eyes                          	Robert John
October 13	
                              Don't Stop 'Til You Get Enough                          	Michael Jackson
October 20	
                              Rise                          	Herb Alpert
November 03	
                              Pop Muzik                          	M
November 10	
                              Heartache Tonight                          	Eagles
November 17	
                              Still                          	Commodores
December 08	
                              Babe                          	Styx
December 22	
                              Escape (The Pina Colada Song)                          	Rupert Holmes
January 05	
                              Please Don't Go                          	KC And The Sunshine Band
January 12	
                              Escape (The Pina Colada Song)                          	Rupert Holmes
January 19	
                              Rock With You                          	Michael Jackson
February 16	
                              Do That To Me One More Time                          	Captain & Tennille
February 23	
                              Crazy Little Thing Called Love                          	Queen
March 22	
                              Another Brick In The Wall (Part II)                          	Pink Floyd
April 19	
                              Call Me                          	Blondie
May 31	
                              Funkytown                          	Lipps, Inc.
June 28	
                              Coming Up (Live At Glasgow)                          	Paul McCartney & Wings
July 19	
                              It's Still Rock And Roll To Me                          	Billy Joel
August 02	
                              Magic                          	Olivia Newton-John
August 30	
                              Sailing                          	Christopher Cross
September 06	
                              Upside Down                          	Diana Ross
October 04	
                              Another One Bites The Dust                          	Queen
October 25	
                              Woman In Love                          	Barbra Streisand
November 15	
                              Lady                          	Kenny Rogers
December 27	
                              (Just Like) Starting Over                          	John Lennon
January 03	
                              (Just Like) Starting Over                          	John Lennon
January 31	
                              The Tide Is High                          	Blondie
February 07	
                              Celebration                          	Kool & The Gang
February 21	
                              9 To 5                          	Dolly Parton
February 28	
                              I Love A Rainy Night                          	Eddie Rabbitt
March 14	
                              9 To 5                          	Dolly Parton
March 21	
                              Keep On Loving You                          	REO Speedwagon
March 28	
                              Rapture                          	Blondie
April 11	
                              Kiss On My List                          	Daryl Hall  John Oates
May 02	
                              Morning Train (Nine To Five)                          	Sheena Easton
May 16	
                              Bette Davis Eyes                          	Kim Carnes
June 20	
                              Medley                          	Stars On 45
June 27	
                              Bette Davis Eyes                          	Kim Carnes
July 25	
                              The One That You Love                          	Air Supply
August 01	
                              Jessie's Girl                          	Rick Springfield
October 17	
                              Arthur's Theme (Best That You Can Do)                          	Christopher Cross
November 07	
                              Private Eyes                          	Daryl Hall  John Oates
November 21	
                              Physical                          	Olivia Newton-John
January 02	
                              Physical                          	Olivia Newton-John
January 30	
                              I Can't Go For That (No Can Do)                          	Daryl Hall  John Oates
February 06	
                              Centerfold                          	The J. Geils Band
March 20	
                              I Love Rock 'N Roll                          	Joan Jett And The Blackhearts
May 08	
                              Chariots Of Fire - Titles                          	Vangelis
July 03	
                              Don't You Want Me                          	The Human League
July 24	
                              Eye Of The Tiger                          	Survivor
September 04	
                              Abracadabra                          	The Steve Miller Band
September 11	
                              Hard To Say I'm Sorry                          	Chicago
September 25	
                              Abracadabra                          	The Steve Miller Band
October 02	
                              Jack & Diane                          	John Cougar
October 30	
                              Who Can It Be Now?                          	Men At Work
November 06	
                              Up Where We Belong                          	Joe Cocker And Jennifer Warnes
November 27	
                              Truly                          	Lionel Richie
December 11	
                              Mickey                          	Toni Basil
December 18	
                              Maneater                          	Daryl Hall  John Oates
January 01	
                              Maneater                          	Daryl Hall  John Oates
January 15	
                              Down Under                          	Men At Work
February 05	
                              Africa                          	Toto
February 12	
                              Down Under                          	Men At Work
March 05	
                              Billie Jean                          	Michael Jackson
April 23	
                              Come On Eileen                          	Dexys Midnight Runners
April 30	
                              Beat It                          	Michael Jackson
May 21	
                              Let's Dance                          	David Bowie
May 28	
                              Flashdance...What A Feeling                          	Irene Cara
July 09	
                              Every Breath You Take                          	The Police
September 03	
                              Sweet Dreams (Are Made Of This)                          	Eurythmics
September 10	
                              Maniac                          	Michael Sembello
September 24	
                              Tell Her About It                          	Billy Joel
October 01	
                              Total Eclipse Of The Heart                          	Bonnie Tyler
November 12	
                              All Night Long (All Night)                          	Lionel Richie
January 21	
                              Owner Of A Lonely Heart                          	Yes
February 04	
                              Karma Chameleon                          	Culture Club
February 25	
                              Jump                          	Van Halen
March 31	
                              Footloose                          	Kenny Loggins
April 21	
                              Against All Odds (Take A Look At Me Now)                          	Phil Collins
May 12	
                              Hello                          	Lionel Richie
May 26	
                              Let's Hear It For The Boy                          	Deniece Williams
June 09	
                              Time After Time                          	Cyndi Lauper
June 23	
                              The Reflex                          	Duran Duran
July 07	
                              When Doves Cry                          	Prince And The Revolution
August 11	
                              Ghostbusters                          	Ray Parker Jr.
September 01	
                              What's Love Got To Do With It                          	Tina Turner
September 22	
                              Missing You                          	John Waite
September 29	
                              Let's Go Crazy                          	Prince And The Revolution
October 13	
                              I Just Called To Say I Love You                          	Stevie Wonder
November 03	
                              Caribbean Queen (No More Love On The Run)                          	Billy Ocean
November 17	
                              Wake Me Up Before You Go-Go                          	Wham!
December 08	
                              Out Of Touch                          	Daryl Hall  John Oates
December 22	
                              Like A Virgin                          	Madonna
January 05	
                              Like A Virgin                          	Madonna
February 02	
                              I Want To Know What Love Is                          	Foreigner
February 16	
                              Careless Whisper                          	Wham!
March 09	
                              Can t Fight This Feeling                          	REO Speedwagon
March 30	
                              One More Night                          	Phil Collins
April 13	
                              We Are The World                          	USA For Africa
May 11	
                              Crazy For You                          	Madonna
May 18	
                              Don t You (Forget About Me)                          	Simple Minds
May 25	
                              Everything She Wants                          	Wham!
June 08	
                              Everybody Wants To Rule The World                          	Tears For Fears
July 06	
                              Sussudio                          	Phil Collins
July 13	
                              A View To A Kill                          	Duran Duran
July 27	
                              Everytime You Go Away                          	Paul Young
August 03	
                              Shout                          	Tears For Fears
August 24	
                              The Power Of Love                          	Huey Lewis 
September 07	
                              St. Elmo s Fire (Man In Motion)                          	John Parr
September 21	
                              Money For Nothing                          	Dire Straits
October 12	
                              Oh Sheila                          	Ready For The World
October 19	
                              Take On Me                          	A-Ha
October 26	
                              Saving All My Love For You                          	Whitney Houston
November 02	
                              Part-Time Lover                          	Stevie Wonder
November 09	
                              Miami Vice Theme                          	Jan Hammer
November 16	
                              We Built This City                          	Starship
December 07	
                              Broken Wings                          	Mr. Mister
December 21	
                              Say You, Say Me (Title Song From White Nights)                          	Lionel Richie
January 04	
                              Say You, Say Me (Title Song From White Nights)                          	Lionel Richie
January 18	
                              That s What Friends Are For                          	Dionne 
February 15	
                              How Will I Know                          	Whitney Houston
March 01	
                              Kyrie                          	Mr. Mister
March 15	
                              Sara                          	Starship
March 22	
                              These Dreams                          	Heart
March 29	
                              Rock Me Amadeus                          	Falco
April 19	
                              Kiss                          	Prince And The Revolution
May 03	
                              Addicted To Love                          	Robert Palmer
May 10	
                              West End Girls                          	Pet Shop Boys
May 17	
                              Greatest Love Of All                          	Whitney Houston
June 07	
                              Live To Tell                          	Madonna
June 14	
                              On My Own                          	Patti LaBelle 
July 05	
                              There ll Be Sad Songs (To Make You Cry)                          	Billy Ocean
July 12	
                              Holding Back The Years                          	Simply Red
July 19	
                              Invisible Touch                          	Genesis
July 26	
                              Sledgehammer                          	Peter Gabriel
August 02	
                              Glory Of Love (Theme From "The Karate Kid Part II")                          	Peter Cetera
August 16	
                              Papa Don t Preach                          	Madonna
August 30	
                              Higher Love                          	Steve Winwood
September 06	
                              Venus                          	Bananarama
September 13	
                              Take My Breath Away (Love Theme From "Top Gun")                          	Berlin
September 20	
                              Stuck With You                          	Huey Lewis 
October 11	
                              When I Think Of You                          	Janet Jackson
October 25	
                              True Colors                          	Cyndi Lauper
November 08	
                              Amanda                          	Boston
November 22	
                              Human                          	The Human League
November 29	
                              You Give Love A Bad Name                          	Bon Jovi
December 13	
                              The Way It Is                          	Bruce Hornsby 
December 20	
                              Walk Like An Egyptian                          	Bangles
January 03	
                              Walk Like An Egyptian                          	Bangles
January 17	
                              Shake You Down                          	Gregory Abbott
January 24	
                              At This Moment                          	Billy Vera 
February 07	
                              Open Your Heart                          	Madonna
February 14	
                              Livin  On A Prayer                          	Bon Jovi
March 14	
                              Jacob s Ladder                          	Huey Lewis 
March 21	
                              Lean On Me                          	Club Nouveau
April 04	
                              Nothing s Gonna Stop Us Now                          	Starship
April 18	
                              I Knew You Were Waiting (For Me)                          	Aretha Franklin 
May 02	
                              (I Just) Died In Your Arms                          	Cutting Crew
May 16	
                              With Or Without You                          	U2
June 06	
                              You Keep Me Hangin  On                          	Kim Wilde
June 13	
                              Always                          	Atlantic Starr
June 20	
                              Head To Toe                          	Lisa Lisa 
June 27	
                              I Wanna Dance With Somebody (Who Loves Me)                          	Whitney Houston
July 11	
                              Alone                          	Heart
August 01	
                              Shakedown (From "Beverly Hills Cop II")                          	Bob Seger
August 08	
                              I Still Haven t Found What I m Looking For                          	U2
August 22	
                              Who s That Girl                          	Madonna
August 29	
                              La Bamba                          	Los Lobos
September 19	
                              I Just Can t Stop Loving You                          	Michael Jackson With Siedah Garrett
September 26	
                              Didn t We Almost Have It All                          	Whitney Houston
October 10	
                              Here I Go Again                          	Whitesnake
October 17	
                              Lost In Emotion                          	Lisa Lisa & Cult Jam Featuring Full Force
October 24	
                              Bad                          	Michael Jackson
November 07	
                              I Think We re Alone Now                          	Tiffany
November 21	
                              Mony Mony                          	Billy Idol
November 28	
                              (I ve Had) The Time Of My Life                          	Bill Medley 
December 05	
                              Heaven Is A Place On Earth                          	Belinda Carlisle
December 12	
                              Faith                          	George Michael
January 02	
                              Faith                          	George Michael
January 09	
                              So Emotional                          	Whitney Houston
January 16	
                              Got My Mind Set On You                          	George Harrison
January 23	
                              The Way You Make Me Feel                          	Michael Jackson
January 30	
                              Need You Tonight                          	INXS
February 06	
                              Could ve Been                          	Tiffany
February 20	
                              Seasons Change                          	Expose
February 27	
                              Father Figure                          	George Michael
March 12	
                              Never Gonna Give You Up                          	Rick Astley
March 26	
                              Man In The Mirror                          	Michael Jackson
April 09	
                              Get Outta My Dreams, Get Into My Car                          	Billy Ocean
April 23	
                              Where Do Broken Hearts Go                          	Whitney Houston
May 07	
                              Wishing Well                          	Terence Trent D Arby
May 14	
                              Anything For You                          	Gloria Estefan & Miami Sound Machine
May 28	
                              One More Try                          	George Michael
June 18	
                              Together Forever                          	Rick Astley
June 25	
                              Foolish Beat                          	Debbie Gibson
July 02	
                              Dirty Diana                          	Michael Jackson
July 09	
                              The Flame                          	Cheap Trick
July 23	
                              Hold On To The Nights                          	Richard Marx
July 30	
                              Roll With It                          	Steve Winwood
August 27	
                              Monkey                          	George Michael
September 10	
                              Sweet Child O  Mine                          	Guns N  Roses
September 24	
                              Don t Worry, Be Happy (From "Cocktail")                          	Bobby McFerrin
October 08	
                              Love Bites                          	Def Leppard
October 15	
                              Red Red Wine                          	UB40
October 22	
                              Groovy Kind Of Love                          	Phil Collins
November 05	
                              Kokomo (From The "Cocktail" Soundtrack)                          	The Beach Boys
November 12	
                              Wild, Wild West                          	The Escape Club
November 19	
                              Bad Medicine                          	Bon Jovi
December 03	
                              Baby, I Love Your Way/Freebird Medley                          	Will To Power
December 10	
                              Look Away                          	Chicago
December 24	
                              Every Rose Has Its Thorn                          	Poison
January 07	
                              Every Rose Has Its Thorn                          	Poison
January 14	
                              My Prerogative                          	Bobby Brown
January 21	
                              Two Hearts                          	Phil Collins
February 04	
                              When I m With You                          	Sheriff
February 11	
                              Straight Up                          	Paula Abdul
March 04	
                              Lost In Your Eyes                          	Debbie Gibson
April 01	
                              Eternal Flame                          	Bangles
April 08	
                              The Look                          	Roxette
April 15	
                              She Drives Me Crazy                          	Fine Young Cannibals
April 22	
                              Like A Prayer                          	Madonna
May 13	
                              I ll Be There For You                          	Bon Jovi
May 20	
                              Forever Your Girl                          	Paula Abdul
June 03	
                              Rock On (From "Dream A Little Dream")                          	Michael Damian
June 10	
                              Wind Beneath My Wings (From "Beaches")                          	Bette Midler
June 17	
                              I ll Be Loving You (Forever)                          	New Kids On The Block
June 24	
                              Satisfied                          	Richard Marx
July 01	
                              Baby Don t Forget My Number                          	Milli Vanilli
July 08	
                              Good Thing                          	Fine Young Cannibals
July 15	
                              If You Don t Know Me By Now                          	Simply Red
July 22	
                              Toy Soldiers                          	Martika
August 05	
                              Batdance (From "Batman")                          	Prince
August 12	
                              Right Here Waiting                          	Richard Marx
September 02	
                              Cold Hearted                          	Paula Abdul
September 09	
                              Hangin  Tough                          	New Kids On The Block
September 16	
                              Don t Wanna Lose You                          	Gloria Estefan
September 23	
                              Girl I m Gonna Miss You                          	Milli Vanilli
October 07	
                              Miss You Much                          	Janet Jackson
November 04	
                              Listen To Your Heart                          	Roxette
November 11	
                              When I See You Smile                          	Bad English
November 25	
                              Blame It On The Rain                          	Milli Vanilli
December 09	
                              We Didn t Start The Fire                          	Billy Joel
December 23	
                              Another Day In Paradise                          	Phil Collins
January 06	
                              Another Day In Paradise                          	Phil Collins
January 20	
                              How Am I Supposed To Live Without You                          	Michael Bolton
March 03	
                              Escapade                          	Janet Jackson
March 24	
                              Black Velvet                          	Alannah Myles
April 07	
                              Love Will Lead You Back                          	Taylor Dayne
April 14	
                              I ll Be Your Everything                          	Tommy Page
April 21	
                              Nothing Compares 2 U                          	Sinead O Connor
May 19	
                              Vogue                          	Madonna
June 09	
                              Hold On                          	Wilson Phillips
June 16	
                              It Must Have Been Love (From "Pretty Woman")                          	Roxette
June 30	
                              Step By Step                          	New Kids On The Block
July 21	
                              She Ain t Worth It                          	Glenn Medeiros Featuring Bobby Brown
August 04	
                              Vision Of Love                          	Mariah Carey
September 01	
                              If Wishes Came True                          	Sweet Sensation
September 08	
                              Blaze Of Glory (From "Young Guns II")                          	Jon Bon Jovi
September 15	
                              Release Me                          	Wilson Phillips
September 29	
                              (Can t Live Without Your) Love And Affection                          	Nelson
October 06	
                              Close To You                          	Maxi Priest
October 13	
                              Praying For Time                          	George Michael
October 20	
                              I Don t Have The Heart                          	James Ingram
October 27	
                              Black Cat                          	Janet Jackson
November 03	
                              Ice Ice Baby                          	Vanilla Ice
November 10	
                              Love Takes Time                          	Mariah Carey
December 01	
                              I m Your Baby Tonight                          	Whitney Houston
December 08	
                              Because I Love You (The Postman Song)                          	Stevie B
January 05	
                              Justify My Love                          	Madonna
January 19	
                              Love Will Never Do (Without You)                          	Janet Jackson
January 26	
                              The First Time                          	Surface
February 09	
                              Gonna Make You Sweat                          	C+C Music Factory
February 23	
                              All The Man That I Need                          	Whitney Houston
March 09	
                              Someday                          	Mariah Carey
March 30	
                              Coming Out Of The Dark                          	Gloria Estefan
April 13	
                              I ve Been Thinking About You                          	Londonbeat
April 20	
                              You re In Love                          	Wilson Phillips
April 27	
                              Baby Baby                          	Amy Grant
May 11	
                              Joyride                          	Roxette
May 18	
                              I Like The Way (The Kissing Game)                          	Hi-Five
May 25	
                              I Don t Wanna Cry                          	Mariah Carey
June 08	
                              More Than Words                          	Extreme
June 15	
                              Rush Rush                          	Paula Abdul
July 20	
                              Unbelievable                          	EMF
September 14	
                              The Promise Of A New Day                          	Paula Abdul
September 21	
                              I Adore Mi Amor                          	Color Me Badd
October 05	
                              Good Vibrations                          	Marky Mark 
October 12	
                              Emotions                          	Mariah Carey
November 02	
                              Romantic                          	Karyn White
November 09	
                              Cream                          	Prince And The N.P.G.
November 23	
                              When A Man Loves A Woman                          	Michael Bolton
November 30	
                              Set Adrift On Memory Bliss                          	P.M. Dawn
December 07	
                              Black Or White                          	Michael Jackson
January 04	
                              Black Or White                          	Michael Jackson
January 25	
                              All 4 Love                          	Color Me Badd
February 08	
                              I m Too Sexy                          	Right Said Fred
February 29	
                              To Be With You                          	Mr. Big
March 21	
                              Save The Best For Last                          	Vanessa Williams
April 25	
                              Jump                          	Kris Kross
June 20	
                              I ll Be There                          	Mariah Carey
July 04	
                              Baby Got Back                          	Sir Mix-A-Lot
August 08	
                              This Used To Be My Playground                          	Madonna
August 15	
                              End Of The Road (From "Boomerang")                          	Boyz II Men
November 14	
                              How Do You Talk To An Angel                          	The Heights
November 28	
                              I Will Always Love You (From "The Bodyguard")                          	Whitney Houston
January 02	
                              I Will Always Love You (From "The Bodyguard")                          	Whitney Houston
March 06	
                              A Whole New World (Aladdin s Theme)                          	Peabo Bryson 
March 13	
                              Informer                          	Snow
May 01	
                              Freak Me                          	Silk
May 15	
                              That s The Way Love Goes                          	Janet Jackson
July 10	
                              Weak                          	SWV
July 24	
                              Can t Help Falling In Love (From "Sliver")                          	UB40
September 11	
                              Dreamlover                          	Mariah Carey
November 06	
                              I d Do Anything For Love (But I Won t Do That)                          	Meat Loaf
November 13	
                              I'd Do Anything For Love (But I Won't Do That)                          	Meat Loaf
December 11	
                              Again                          	Janet Jackson
December 25	
                              Hero                          	Mariah Carey
January 01	
                              Hero                          	Mariah Carey
February 12	
                              The Power Of Love                          	Celine Dion
March 12	
                              The Sign                          	Ace Of Base
April 09	
                              Bump N  Grind                          	R. Kelly
May 07	
                              The Sign                          	Ace Of Base
May 21	
                              I Swear                          	All-4-One
August 06	
                              Stay (I Missed You) (From "Reality Bites")                          	Lisa Loeb 
August 27	
                              I ll Make Love To You                          	Boyz II Men
December 03	
                              On Bended Knee                          	Boyz II Men
December 17	
                              Here Comes The Hotstepper (From "Ready To Wear")                          	Ini Kamoze
December 31	
                              On Bended Knee                          	Boyz II Men
January 07	
                              On Bended Knee                          	Boyz II Men
January 28	
                              Creep                          	TLC
February 25	
                              Take A Bow                          	Madonna
April 15	
                              This Is How We Do It                          	Montell Jordan
July 08	
                              Waterfalls                          	TLC
August 26	
                              Kiss From A Rose (From "Batman Forever")                          	Seal
September 02	
                              You Are Not Alone                          	Michael Jackson
September 09	
                              Gangsta's Paradise (From "Dangerous Minds")                          	Coolio Featuring L.V.
September 30	
                              Fantasy                          	Mariah Carey
November 25	
                              Exhale (Shoop Shoop) (From "Waiting To Exhale")                          	Whitney Houston
March 23	
                              Because You Loved Me (From "Up Close & Personal")                          	Celine Dion
May 04	
                              Always Be My Baby                          	Mariah Carey
May 18	
                              Tha Crossroads                          	Bone Thugs-N-Harmony
July 13	
                              How Do U Want It/California Love                          	2Pac Featuring KC And JoJo
July 27	
                              You're Makin' Me High/Let It Flow                          	Toni Braxton
August 03	
                              Macarena (Bayside Boys Mix)                          	Los Del Rio
November 09	
                              No Diggity                          	BLACKstreet (Featuring Dr. Dre)
December 07	
                              Un-Break My Heart                          	Toni Braxton
January 04	
                              Un-Break My Heart                          	Toni Braxton
February 22	
                              Wannabe                          	Spice Girls
May 03	
                              Hypnotize                          	The Notorious B.I.G.
May 24	
                              Mmmbop                          	Hanson
June 28	
                              I ll Be Missing You                          	Puff Daddy 
August 30	
                              Mo Money Mo Problems                          	The Notorious B.I.G. Featuring Puff Daddy & Mase
September 13	
                              Honey                          	Mariah Carey
October 04	
                              4 Seasons Of Loneliness                          	Boyz II Men
October 11	
                              Candle In The Wind 1997/Something About The Way You Look Tonight                          	Elton John
January 03	
                              Candle In The Wind 1997/Something About The Way You Look Tonight                          	Elton John
January 17	
                              Truly Madly Deeply                          	Savage Garden
January 31	
                              Together Again                          	Janet
February 14	
                              Nice & Slow                          	Usher
February 28	
                              My Heart Will Go On                          	Celine Dion
March 14	
                              Gettin' Jiggy Wit It                          	Will Smith
April 04	
                              All My Life                          	K-Ci & JoJo
April 18	
                              All My Life                          	K-Ci 
April 25	
                              Too Close                          	Next
May 23	
                              My All                          	Mariah Carey
May 30	
                              Too Close                          	Next
June 06	
                              The Boy Is Mine                          	Brandy 
August 15	
                              The Boy Is Mine                          	Brandy & Monica
August 22	
                              The Boy Is Mine                          	Brandy 
September 05	
                              I Don t Want To Miss A Thing                          	Aerosmith
September 12	
                              I Don't Want To Miss A Thing                          	Aerosmith
October 03	
                              The First Night                          	Monica
October 17	
                              One Week                          	Barenaked Ladies
October 24	
                              The First Night                          	Monica
November 14	
                              Doo Wop (That Thing)                          	Lauryn Hill
November 28	
                              Lately                          	Divine
December 05	
                              I m Your Angel                          	R. Kelly 
January 02	
                              I m Your Angel                          	R. Kelly 
January 16	
                              Have You Ever?                          	Brandy
January 30	
                              ...Baby One More Time                          	Britney Spears
February 13	
                              Angel Of Mine                          	Monica
March 13	
                              Believe                          	Cher
April 10	
                              No Scrubs                          	TLC
May 08	
                              Livin  La Vida Loca                          	Ricky Martin
June 12	
                              If You Had My Love                          	Jennifer Lopez
July 17	
                              Bills, Bills, Bills                          	Destiny s Child
July 24	
                              Wild Wild West                          	Will Smith Featuring Dru Hill 
July 31	
                              Genie In A Bottle                          	Christina Aguilera
September 04	
                              Bailamos                          	Enrique Iglesias
September 18	
                              Unpretty                          	TLC
October 09	
                              Heartbreaker                          	Mariah Carey Featuring Jay-Z
October 23	
                              Smooth                          	Santana Featuring Rob Thomas
January 01	
                              Smooth                          	Santana Featuring Rob Thomas
January 15	
                              What A Girl Wants                          	Christina Aguilera
January 29	
                              I Knew I Loved You                          	Savage Garden
February 19	
                              Thank God I Found You                          	Mariah Carey Featuring Joe 
February 26	
                              I Knew I Loved You                          	Savage Garden
March 04	
                              Amazed                          	Lonestar
March 18	
                              Say My Name                          	Destiny s Child
April 08	
                              Maria Maria                          	Santana Featuring The Product G
June 17	
                              Try Again                          	Aaliyah
June 24	
                              Be With You                          	Enrique Iglesias
July 15	
                              Everything You Want                          	Vertical Horizon
July 22	
                              Bent                          	matchbox twenty
August 12	
                              Incomplete                          	Sisqo
August 26	
                              Doesn t Really Matter                          	Janet
September 16	
                              Music                          	Madonna
October 14	
                              Come On Over Baby (All I Want Is You)                          	Christina Aguilera
November 11	
                              With Arms Wide Open                          	Creed
November 18	
                              Independent Women Part I                          	Destiny s Child
December 23	
                              Independent Women Part I                          	Destiny's Child
January 06	
                              Independent Women Part I                          	Destiny's Child
February 03	
                              It Wasn't Me                          	Shaggy Featuring Ricardo "RikRok" Ducent
February 17	
                              Ms. Jackson                          	OutKast
February 24	
                              Stutter                          	Joe Featuring Mystikal
March 24	
                              Butterfly                          	Crazy Town
March 31	
                              Angel                          	Shaggy Featuring Rayvon
April 07	
                              Butterfly                          	Crazy Town
April 14	
                              All For You                          	Janet
July 07	
                              U Remind Me                          	Usher
August 04	
                              Bootylicious                          	Destiny's Child
August 18	
                              Fallin'                          	Alicia Keys
September 08	
                              I'm Real                          	Jennifer Lopez Featuring Ja Rule
September 29	
                              Fallin'                          	Alicia Keys
October 20	
                              I'm Real                          	Jennifer Lopez Featuring Ja Rule
November 03	
                              Family Affair                          	Mary J. Blige
December 15	
                              U Got It Bad                          	Usher
December 22	
                              How You Remind Me                          	Nickelback
January 05	
                              How You Remind Me                          	Nickelback
January 19	
                              U Got It Bad                          	Usher
February 23	
                              Always On Time                          	Ja Rule Featuring Ashanti
March 09	
                              Ain't It Funny                          	Jennifer Lopez Featuring Ja Rule
April 20	
                              Foolish                          	Ashanti
June 29	
                              Hot In Herre                          	Nelly
August 17	
                              Dilemma                          	Nelly Featuring Kelly Rowland
October 05	
                              A Moment Like This                          	Kelly Clarkson
October 19	
                              Dilemma                          	Nelly Featuring Kelly Rowland
November 09	
                              Lose Yourself                          	Eminem
January 04	
                              Lose Yourself                          	Eminem
February 08	
                              All I Have                          	Jennifer Lopez Featuring LL Cool J
March 08	
                              In Da Club                          	50 Cent
May 10	
                              Get Busy                          	Sean Paul
May 31	
                              21 Questions                          	50 Cent Featuring Nate Dogg
June 28	
                              This Is The Night                          	Clay Aiken
July 12	
                              Crazy In Love                          	Beyonce Featuring Jay-Z
September 06	
                              Shake Ya Tailfeather                          	Nelly, P. Diddy & Murphy Lee
October 04	
                              Baby Boy                          	Beyonce Featuring Sean Paul
December 06	
                              Stand Up                          	Ludacris Featuring Shawnna
December 13	
                              Hey Ya!                          	OutKast
January 03	
                              Hey Ya!                          	OutKast
February 21	
                              Slow Jamz                          	Twista Featuring Kanye West & Jamie Foxx
February 28	
                              Yeah!                          	Usher Featuring Lil Jon & Ludacris
May 22	
                              Burn                          	Usher
July 10	
                              I Believe                          	Fantasia
July 17	
                              Burn                          	Usher
July 24	
                              Confessions Part II                          	Usher
August 07	
                              Slow Motion                          	Juvenile Featuring Soulja Slim
August 21	
                              Lean Back                          	Terror Squad
September 11	
                              Goodies                          	Ciara Featuring Petey Pablo
December 11	
                              Drop It Like It's Hot                          	Snoop Dogg Featuring Pharrell
January 01	
                              Let Me Love You                          	Mario
March 05	
                              Candy Shop                          	50 Cent Featuring Olivia
May 07	
                              Hollaback Girl                          	Gwen Stefani
June 04	
                              We Belong Together                          	Mariah Carey
July 02	
                              Inside Your Heaven                          	Carrie Underwood
July 09	
                              We Belong Together                          	Mariah Carey
September 17	
                              Gold Digger                          	Kanye West Featuring Jamie Foxx
November 26	
                              Run It!                          	Chris Brown
December 31	
                              Don't Forget About Us                          	Mariah Carey
January 07	
                              Don't Forget About Us                          	Mariah Carey
January 14	
                              Laffy Taffy                          	D4L
January 21	
                              Grillz                          	Nelly Featuring Paul Wall, Ali & Gipp
February 04	
                              Check On It                          	Beyonce Featuring Slim Thug
March 11	
                              You're Beautiful                          	James Blunt
March 18	
                              So Sick                          	Ne-Yo
April 01	
                              Temperature                          	Sean Paul
April 08	
                              Bad Day                          	Daniel Powter
May 13	
                              SOS                          	Rihanna
June 03	
                              Ridin'                          	Chamillionaire Featuring Krayzie Bone
June 17	
                              Hips Don't Lie                          	Shakira Featuring Wyclef Jean
July 01	
                              Do I Make You Proud                          	Taylor Hicks
July 08	
                              Promiscuous                          	Nelly Furtado Featuring Timbaland
August 19	
                              London Bridge                          	Fergie
September 09	
                              SexyBack                          	Justin Timberlake
October 28	
                              Money Maker                          	Ludacris Featuring Pharrell
November 11	
                              My Love                          	Justin Timberlake Featuring T.I.
December 02	
                              I Wanna Love You                          	Akon Featuring Snoop Dogg
December 16	
                              Irreplaceable                          	Beyonce
January 06	
                              Irreplaceable                          	Beyonce
February 24	
                              Say It Right                          	Nelly Furtado
March 03	
                              What Goes Around...Comes Around                          	Justin Timberlake
March 10	
                              This Is Why I'm Hot                          	Mims
March 24	
                              Glamorous                          	Fergie Featuring Ludacris
April 07	
                              Don't Matter                          	Akon
April 21	
                              Give It To Me                          	Timbaland Featuring Nelly Furtado & Justin Timberlake
May 05	
                              Girlfriend                          	Avril Lavigne
May 12	
                              Makes Me Wonder                          	Maroon5
May 26	
                              Buy U A Drank (Shawty Snappin')                          	T-Pain Featuring Yung Joc
June 02	
                              Makes Me Wonder                          	Maroon5
June 09	
                              Umbrella                          	Rihanna Featuring Jay-Z
July 28	
                              Hey There Delilah                          	Plain White T's
August 11	
                              Beautiful Girls                          	Sean Kingston
September 08	
                              Big Girls Don't Cry                          	Fergie
September 15	
                              Crank That (Soulja Boy)                          	Soulja Boy
September 29	
                              Stronger                          	Kanye West
October 06	
                              Crank That (Soulja Boy)                          	Soulja Boy Tell'em
November 10	
                              Kiss Kiss                          	Chris Brown Featuring T-Pain
December 01	
                              No One                          	Alicia Keys
January 05	
                              Low                          	Flo Rida Featuring T-Pain
March 15	
                              Love In This Club                          	Usher Featuring Young Jeezy
April 05	
                              Bleeding Love                          	Leona Lewis
April 12	
                              Touch My Body                          	Mariah Carey
April 26	
                              Bleeding Love                          	Leona Lewis
May 03	
                              Lollipop                          	Lil Wayne Featuring Static Major
May 10	
                              Bleeding Love                          	Leona Lewis
May 24	
                              Take A Bow                          	Rihanna
May 31	
                              Lollipop                          	Lil Wayne Featuring Static Major
June 28	
                              Viva La Vida                          	Coldplay
July 05	
                              I Kissed A Girl                          	Katy Perry
August 23	
                              Disturbia                          	Rihanna
September 06	
                              Whatever You Like                          	T.I.
September 27	
                              So What                          	Pink
October 04	
                              Whatever You Like                          	T.I.
October 18	
                              Live Your Life                          	T.I. Featuring Rihanna
October 25	
                              Womanizer                          	Britney Spears
November 01	
                              Whatever You Like                          	T.I.
November 15	
                              Live Your Life                          	T.I. Featuring Rihanna
December 13	
                              Single Ladies (Put A Ring On It)                          	Beyonce
December 20	
                              Live Your Life                          	T.I. Featuring Rihanna
December 27	
                              Single Ladies (Put A Ring On It)                          	Beyonce
January 03	
                              Single Ladies (Put A Ring On It)                          	Beyonce
January 17	
                              Just Dance                          	Lady GaGa Featuring Colby O'Donis
February 07	
                              My Life Would Suck Without You                          	Kelly Clarkson
February 28	
                              Right Round                          	Flo Rida
March 07	
                              Right Round                          	Flo Rida Featuring Ke$ha
March 14	
                              Right Round                          	Flo Rida
April 11	
                              Poker Face                          	Lady GaGa
April 18	
                              Boom Boom Pow                          	The Black Eyed Peas
July 11	
                              I Gotta Feeling                          	The Black Eyed Peas
October 17	
                              Down                          	Jay Sean Featuring Lil Wayne
October 24	
                              3                          	Britney Spears
October 31	
                              Down                          	Jay Sean Featuring Lil Wayne
November 07	
                              Fireflies                          	Owl City
November 14	
                              Whatcha Say                          	Jason DeRulo
November 21	
                              Fireflies                          	Owl City
January 02	
                              TiK ToK                          	Ke$ha
March 06	
                              Imma Be                          	The Black Eyed Peas
March 20	
                              Break Your Heart                          	Taio Cruz Featuring Ludacris
March 27	
                              Rude Boy                          	Rihanna
May 01	
                              Nothin' On You                          	B.o.B Featuring Bruno Mars
May 15	
                              OMG                          	Usher Featuring will.i.am
May 22	
                              Not Afraid                          	Eminem
May 29	
                              OMG                          	Usher Featuring will.i.am
June 19	
                              California Gurls                          	Katy Perry Featuring Snoop Dogg
July 31	
                              Love The Way You Lie                          	Eminem Featuring Rihanna
September 18	
                              Teenage Dream                          	Katy Perry
October 02	
                              Just The Way You Are                          	Bruno Mars
November 13	
                              We R Who We R                          	Ke$ha
November 20	
                              What's My Name?                          	Rihanna Featuring Drake
December 04	
                              Only Girl (In The World)                          	Rihanna
December 11	
                              Raise Your Glass                          	P!nk
December 18	
                              Firework                          	Katy Perry
January 01	
                              Firework                          	Katy Perry
January 08	
                              Grenade                          	Bruno Mars
January 15	
                              Firework                          	Katy Perry
January 22	
                              Grenade                          	Bruno Mars
January 29	
                              Hold It Against Me                          	Britney Spears
February 05	
                              Grenade                          	Bruno Mars
February 19	
                              Black And Yellow                          	Wiz Khalifa
February 26	
                              Born This Way                          	Lady Gaga
April 30	
                              S&M                          	Rihanna Featuring Britney Spears
May 21	
                              Rolling In The Deep                          	Adele
July 09	
                              Give Me Everything                          	Pitbull Featuring Ne-Yo, Afrojack & Nayer
July 16	
                              Party Rock Anthem                          	LMFAO Featuring Lauren Bennett & GoonRock
August 27	
                              Last Friday Night (T.G.I.F.)                          	Katy Perry
September 10	
                              Moves Like Jagger                          	Maroon 5 Featuring Christina Aguilera
September 17	
                              Someone Like You                          	Adele
September 24	
                              Moves Like Jagger                          	Maroon 5 Featuring Christina Aguilera
October 15	
                              Someone Like You                          	Adele
November 12	
                              We Found Love                          	Rihanna Featuring Calvin Harris
January 05	
                              Locked Out Of Heaven                          	Bruno Mars
February 02	
                              Thrift Shop                          	Macklemore & Ryan Lewis Featuring Wanz
March 02	
                              Harlem Shake                          	Baauer
April 06	
                              Thrift Shop                          	Macklemore & Ryan Lewis Featuring Wanz
April 20	
                              When I Was Your Man                          	Bruno Mars
April 27	
                              Just Give Me A Reason                          	P!nk Featuring Nate Ruess
May 18	
                              Can't Hold Us                          	Macklemore & Ryan Lewis Featuring Ray Dalton
June 22	
                              Blurred Lines                          	Robin Thicke Featuring T.I. + Pharrell
September 14	
                              Roar                          	Katy Perry
September 28	
                              Wrecking Ball                          	Miley Cyrus
October 12	
                              Royals                          	Lorde
December 14	
                              Wrecking Ball                          	Miley Cyrus
December 21	
                              The Monster                          	Eminem Featuring Rihanna
January 04	
                              The Monster                          	Eminem Featuring Rihanna
January 18	
                              Timber                          	Pitbull Featuring Ke$ha
February 08	
                              Dark Horse                          	Katy Perry Featuring Juicy J
March 08	
                              Happy                          	Pharrell Williams
May 17	
                              All Of Me                          	John Legend
June 07	
                              Fancy                          	Iggy Azalea Featuring Charli XCX
July 26	
                              Rude                          	MAGIC!
September 06	
                              Shake It Off                          	Taylor Swift
September 20	
                              All About That Bass                          	Meghan Trainor
November 15	
                              Shake It Off                          	Taylor Swift
November 29	
                              Blank Space                          	Taylor Swift
January 07	
                              Sexy And I Know It                          	LMFAO
January 21	
                              We Found Love                          	Rihanna Featuring Calvin Harris
February 04	
                              Set Fire To The Rain                          	Adele
February 18	
                              Stronger (What Doesn't Kill You)                          	Kelly Clarkson
March 03	
                              Part Of Me                          	Katy Perry
March 10	
                              Stronger (What Doesn't Kill You)                          	Kelly Clarkson
March 17	
                              We Are Young                          	fun. Featuring Janelle Monae
April 28	
                              Somebody That I Used To Know                          	Gotye Featuring Kimbra
June 23	
                              Call Me Maybe                          	Carly Rae Jepsen
August 25	
                              Whistle                          	Flo Rida
September 01	
                              We Are Never Ever Getting Back Together                          	Taylor Swift
September 15	
                              Whistle                          	Flo Rida
September 22	
                              We Are Never Ever Getting Back Together                          	Taylor Swift
September 29	
                              One More Night                          	Maroon 5
December 01	
                              Diamonds                          	Rihanna
December 22	
                              Locked Out Of Heaven                          	Bruno Mars
January 03	
                              Blank Space                          	Taylor Swift
January 17	
                              Uptown Funk!                          	Mark Ronson Featuring Bruno Mars
April 25	
                              See You Again                          	Wiz Khalifa Featuring Charlie Puth
June 06	
                              Bad Blood                          	Taylor Swift Featuring Kendrick Lamar
June 13	
                              See You Again                          	Wiz Khalifa Featuring Charlie Puth
July 25	
                              Cheerleader                          	OMI
August 22	
                              Can't Feel My Face                          	The Weeknd
August 29	
                              Cheerleader                          	OMI
September 12	
                              Can't Feel My Face                          	The Weeknd
September 19	
                              What Do You Mean?                          	Justin Bieber
September 26	
                              Can't Feel My Face                          	The Weeknd
October 03	
                              The Hills                          	The Weeknd
November 14	
                              Hello                          	Adele
January 02	
                              Hello                          	Adele
January 23	
                              Sorry                          	Justin Bieber
February 13	
                              Love Yourself                          	Justin Bieber
February 20	
                              Pillowtalk                          	Zayn
February 27	
                              Love Yourself                          	Justin Bieber
March 05	
                              Work                          	Rihanna Featuring Drake
May 07	
                              Panda                          	Desiigner
May 21	
                              One Dance                          	Drake Featuring WizKid & Kyla
May 28	
                              Can't Stop The Feeling!                          	Justin Timberlake
June 04	
                              One Dance                          	Drake Featuring WizKid & Kyla
August 06	
                              Cheap Thrills                          	Sia Featuring Sean Paul
September 03	
                              Closer                          	The Chainsmokers Featuring Halsey
November 26	
                              Black Beatles                          	Rae Sremmurd Featuring Gucci Mane
